10 1 1 1 1 1 0 1 1 8 2 5 1
13 1 8 3 5 1 13 13 1 1 2 3 1
5 1 6 13 9 8 2 2 5 2 1 13 1
13 1 1 13 1 1 2 1 1 2 1 13 1
13 1 3 9 3 5 13 1 3 5 2 13 1
9 9 13 13 13 13 13 1 5 1 13 13 1
1 2 13 1 1 1 13 1 3 13 13 13 1
1 2 13 1 5 1 13 1 1 1 13 1 1
1 4 1 1 9 1 13 1 5 9 13 9 8
8 4 13 13 13 13 3 1 1 1 13 1 1
13 1 13 1 9 1 13 13 13 1 13 9 2
13 1 13 1 12 1 13 1 1 1 13 1 5
13 13 13 1 1 1 3 13 13 13 13 1 1
